w                              w
w                              w
w                              w
w                              w
w                              w
w                              w
w                              w
w                              w
w                              w
w                              w
w                              w
w                              w
w                              w
w                              w
w                              w
w s             w              w
w              www             w
wwwwwwwwwwwwwwwwwwwwwwwwwwwwwwww
