w                              w
w                              w
w                              w
w                              w
w                              w
w                              w
w                              w
w                              w
w                              w
w                              w
w                       e      w
w                              w
w   s                          w
wfffffffw                      w
w       fffff                  w
w         l     w              w
w              www      e      w
wwwwwwwwwwwwwwwwwwwwwwwwwwwwwwww
