w                              w
w                              w
w                              w
w                              w
w                              w
w                              w
w                              w
w                              w
w                              w
w                       l      w
w             l         e      w
w       fff        wfffffff    w
wwwww            fff           w
wffffffffff                l   w
w   l        lfffffff          w
w                      wwwwwwwww
we  s      wwwwwwwwwwwwwwwwwwwww
wwwwwwwwwwwwwwwwwwwwwwwwwwwwwwww
