wwww                        wwww
ww                            ww
w                              w
w                          l   w
w                              w
w                         ww   w
w                        www e w
w                      wwwwwwwww
w                     f        |
w                    f         |
w                   f          |
w                  f           |
w            ff  ff            |
w           f                  |
w l        f                   |
w         w                    |
ws       ww                    |
wwww   wwww                    |
