w                              w
w                              w
w                              w
w                              w
w                              w
w                              w
w                              w
w                              w
w                              w
w                              w
w                       e      w
w                              w
w                              w
wfffffffw                      w
w   l   fffff                  w
w               w              w
w   s          www      e      w
wwwwwwwwwwwwwwwwwwwwwwwwwwwwwwww
