w                              w
w                              w
w                        s     w
w                              w
w                              w
w                              w
w                              w
w                              w
w                              w
w                              w
w                              w
w                              w
w                              w
wfffffff                       w
w                              w
w               w              w
w              www             w
ffffffffffffffffffffffffffffffff
